level_size: 24 24
player_pos: 12 15
player_dir: 180

1 1 1 1 1 1 1 1 1 1 1 1 1 1 1 1 1 1 1 1 1 1 1 1
1 0 0 0 0 0 0 0 0 0 0 0 0 0 0 0 0 0 0 0 0 0 0 1
1 0 0 0 0 0 0 0 0 0 0 0 0 0 0 0 0 0 0 0 0 0 0 1
1 0 0 0 0 0 0 0 0 0 0 0 0 0 0 0 0 0 0 0 0 0 0 1
1 0 0 0 0 0 2 2 2 2 2 0 0 0 0 3 0 3 0 3 0 0 0 1
1 0 0 0 0 0 2 0 0 0 2 0 0 7 0 0 0 0 0 0 0 0 0 1
1 0 0 0 0 0 2 0 14 0 2 0 0 0 0 3 0 0 0 3 0 0 0 1
1 0 0 0 0 0 2 0 0 0 2 0 0 14 0 0 0 0 0 0 0 0 0 1
1 0 0 0 0 0 2 2 0 2 2 0 0 0 0 3 0 3 0 3 0 0 0 1
1 0 0 0 0 0 0 0 0 0 0 0 0 9 0 0 0 0 0 0 0 0 0 1
1 0 0 0 0 0 0 0 0 0 0 0 0 0 0 0 0 0 0 0 0 0 0 1
1 0 0 0 0 0 0 0 0 0 0 0 0 14 0 0 0 0 0 0 0 0 0 1
1 0 0 0 0 0 0 0 0 0 0 0 0 0 0 0 0 0 0 0 0 0 0 1
1 0 0 0 0 0 0 0 0 0 0 0 0 0 0 0 0 0 0 0 0 0 0 1
1 0 0 0 0 0 0 0 0 0 0 0 0 0 0 0 0 0 0 0 0 0 0 1
1 0 0 0 0 0 0 0 0 0 0 0 0 0 0 0 0 0 0 0 0 0 0 1
1 4 4 4 4 4 4 4 4 0 0 0 0 0 0 0 0 0 0 0 0 0 0 1
1 4 0 4 0 0 0 0 4 0 0 0 0 0 0 0 0 0 0 0 0 0 0 1
1 4 0 0 0 0 0 0 4 0 0 0 0 0 0 0 0 0 0 0 0 0 0 1
1 4 0 4 0 0 0 0 4 0 0 0 0 0 0 0 0 0 0 0 0 0 0 1
1 4 0 4 4 4 4 4 4 0 0 0 0 0 0 0 0 0 0 0 0 0 0 1
1 4 0 0 0 0 0 0 0 0 0 0 0 0 0 0 0 0 0 0 0 5 5 1
1 4 4 4 4 4 4 4 4 0 0 0 0 0 0 0 0 0 0 0 0 5 5 1
1 1 1 1 1 1 1 1 1 1 1 1 1 1 1 1 1 1 1 1 1 1 1 1