level_size: 24 24
player_pos: 22 21
player_dir: 90

1 1 1 1 1 1 1 1 1 1 1 1 1 1 1 1 1 1 1 1 1 1 1 1
1 0 0 0 0 0 0 0 0 0 0 0 0 0 0 0 0 0 0 0 0 0 0 1
1 0 0 0 0 0 0 0 0 0 0 0 0 0 0 0 0 0 0 0 0 0 0 1
1 0 0 0 0 0 0 0 0 0 0 0 0 0 0 0 0 0 0 0 0 0 0 1
1 0 0 0 0 0 2 2 2 2 2 0 0 0 0 3 0 3 0 3 0 0 0 1
1 0 0 0 0 0 2 0 0 0 2 0 0 0 0 0 0 0 0 0 0 0 0 1
1 0 0 0 0 0 2 0 0 0 2 0 0 0 0 3 0 0 0 3 0 0 0 1
1 0 0 0 0 0 2 0 0 0 2 0 0 0 0 0 0 0 0 0 0 0 0 1
1 0 0 0 0 0 2 2 0 2 2 0 0 0 0 3 0 3 0 3 0 0 0 1
1 0 0 0 0 0 0 0 0 0 0 0 0 0 0 0 0 0 0 0 0 0 0 1
1 0 0 0 0 0 0 0 0 0 0 0 0 0 0 0 0 0 0 0 0 0 0 1
1 0 0 0 0 0 0 0 0 0 0 0 0 0 0 0 0 0 0 0 0 0 0 1
1 0 0 0 0 0 0 0 0 0 0 0 0 0 0 0 0 0 0 0 0 0 0 1
1 0 0 0 0 0 0 0 0 0 0 0 0 0 0 0 0 0 0 0 0 0 0 1
1 0 0 0 0 0 0 0 0 0 0 0 0 0 0 0 0 0 0 0 0 0 0 1
1 0 0 0 0 0 0 0 0 0 0 0 0 0 0 0 0 0 0 0 0 0 0 1
4 4 4 4 4 4 4 4 4 0 4 0 0 0 0 0 0 0 0 0 0 0 0 1
4 4 0 0 0 0 0 0 4 0 4 0 0 0 0 0 0 0 0 0 0 0 0 1
4 4 0 4 4 4 4 0 4 0 4 0 0 0 0 0 0 0 0 0 0 0 0 1
4 4 0 4 0 8 4 0 4 0 4 0 0 0 0 0 0 0 0 0 0 0 0 1
4 4 0 4 0 0 0 0 4 0 4 0 0 0 0 0 0 0 0 0 0 5 5 1
4 4 0 4 4 4 4 4 4 0 4 0 0 0 0 0 0 0 0 0 0 0 0 1
4 4 0 0 0 0 0 0 0 0 4 0 0 0 0 0 0 0 0 0 0 5 5 1
4 4 4 4 4 4 4 4 4 4 4 1 1 1 1 1 1 1 1 1 1 1 1 1